00000000122
00100001222
00000012222
00000122222
00000122222
00000122222
00000122222
00000122222
00000122122
00000122122
01000012222
00000001222