02300234
00000230
32123234
00200234
00304444
44444444